   WE                            textures/sandy.xpm
NO textures/squidward.xpm



SO textures/patrick.xpm

F     17,   38,     64

EA textures/spongebob.xpm
C 218, 234, 235




1111111111111111111111111
10S01100001000000000000011111111
1000110000000000111111001      1
10001100000000001100010011    11
1000000000100000000001001
1111111111111111111111111
